=================
=         X    $=
= X  $ $ $ $ $ $=
= X  $ $ $ $ $ $=
= X  $         $=
=    $         $=
==========  =====
=                
=================